LLLLLLLLLLLLLL
RRRRRRHRRRRRRR
RRRRRRRRRRRHRR
GGGGGGGGGGGGGG
RRHRRRRRRRRRRR
GGGGGGGGGGGGGG
RRRRRRHRRRRRRR
GGGGGGGGGGGGGG
RRRRRRRRRHRRRR
GGGGGGGGGGGGGG
RRRRHRRRRRRRRR
GGGGGGGGGGGGGG