LLLLLLLLLL
RRRRRRRRRR
GGGGGGGGGG
RRRRRRRRRR
GGGGGGGGGG
RRRRRRRRRR
GGGGGGGGGG
RRRRRRRRRR
GGGGGGGGGG
RRRRRRRRRR
GGGGFGGGGG