LLLLLLLLLLLLLL
RRRRRRRRRRRHRR
GGGGGGGGGGGGGG
RRRRRRRRRHRRRR
RRHRRRRRRRRRRR
GGGGGGGGGGGGGG
RRRRRRRRRHRRRR
RHRRRRRRRRRRRR
GGGGGGGGGGGGGG
RRRRRRRRRHRRRR
RRRRRRRHRRRRRR
GGGGGGGGGGGGGG
RRRRHRRRRRRRRR
GGGGGGGGGGGGGG