LLLLLLLLLLLLLL
RRRRRRRRRRRRRR
RRRRRRRRRRRRRR
RRRRRRRRRRRRRR
RRRRRRRRRRRRRR
GGGHGGGGGGGGGG
RRRRRRRRRRRRRR
GGGGGGGGHGGGGG
RRRRRRRRRRRRRR
GGGGGGHGGGGGGG
RRRRRRRRRRRRRR
GGGGHGGGGGGGGG
RRRRRRRRRRRRRR
GGGGGGGGGGGGGG