LLLLLLLLLLLLLL
RRRRRRRRRRRRRR
GGGGGGGGGGGGGG
RRRRRRRRRRRRRR
GGGGGGGGGGGGGG
RRRRRRRRRRRRRR
GGGGGGGGGGGGGG
RRRRRRRRRRRRRR
GGGGGGGGGGGGGG
RRRRRRRRRRRRRR
GGGGGGGGGGGGGG